Quiz Name,Date Taken,Score,Questions Attempted,Correct Answers,Wrong Answers
Organic Chemistry,N/A,4,7,4,3
Organic Chemistry,N/A,4,7,4,3
Police quiz 1,N/A,9,10,9,1
Eng Police 2,N/A,7,12,7,5
Geometry Challenge,N/A,0,1,0,1
Geometry Challenge,N/A,0,4,0,4
Geometry Challenge,N/A,0,1,0,1
Geometry Challenge,N/A,1,4,1,3
Geometry Challenge,N/A,0,4,0,4
Geometry Challenge,N/A,1,3,1,2
Geometry Challenge,N/A,0,4,0,4
Geometry Challenge,2025-03-25,1,4,1,3
Geometry Challenge,2025-03-25,1,4,1,3
Geometry Challenge,2025-03-25,2,4,2,2
Geometry Challenge,2025-03-25,2,3,2,1
Organic Chemistry,2025-03-25,4,7,4,3
Organic Chemistry,2025-03-25,1,2,1,1
HP gk FOR cOMMANDOO,2025-03-26,8,10,8,2
Geometry Challenge,2025-03-27,3,4,3,1
Organic Chemistry,2025-03-28,4,7,4,3
new alzz quizz,2025-03-28,0,0,0,0
new alzz quizz,2025-03-28,0,0,0,0
new alzz quizz,2025-03-28,0,0,0,0
Commando 1,2025-06-26,3,10,3,7
Geometry Challenge,2025-07-26,0,5,0,5
Organic Chemistry,2025-07-26,0,6,0,6
Organic Chemistry,2025-07-27,0,6,0,6
Eng Police 2,2025-07-28,0,0,0,0
Geometry Challenge,2025-07-28,0,1,0,1
Hadappa,2025-07-28,0,1,0,1
Geometry Challenge,2025-07-28,0,5,0,5
